555515555
511111115
515515515
515511115
515555555
511115555
555525555
555525555
555525555
555525555
555525555
555525555
555525555
555525555
555525555
555525555
555525555
555525555
555525555
555525555
555525555
555515555
555515555
511115555
515555555
511111225
555555515
555512215
555515555
555525555
555525555
555525555
555525555
555525555
555525555
555525555
555525555
555525555
555525555
555525555
555525555
555525555
555545555