11111222555
55551552555
55551551555
55551111114
55555555555
55555555555