55551555555555
55551555555555
55551555555555
55551555555555
55551555555555
55551555555555
55551555555555
55551555555555
55551555555555
55551555555555
55551555555555
55551555555555
11111555222222
15555555255552
15555555255551
15555555255551
25555555255551
25555555255551
22222222211112
55555551155555
55555551555555
55555551555555
55222221222255
55155551555155
55155551222255
55155551555555
55122221225555
55555555515555
55555555512455