11112222555
55551552555
55551551555
55551111555
55551551555
55551551555
55551222555
55551111114